XXXXXXXXXXXXXXXXXXXXXXXXX
X                       X
X                       X
X                       X
X                       X
X  H                    X
X                       X
X                       X
X                       X
X                       X
X                       X
X                       X
X                       X
X                       X
X                       X
X                       X
X                       X
X                       X
X                       X
X                       X
X                       X
X                       X
X                       X
XF                      X
X                       X
XXXXXXXXXXXXXXXXXXXXXXXXX