XXXXXXXXXXXXXXXXXXXXXXXXX
X                       X
X                       X
X                       X
X                       X
X  H                    X
X                       X
X          B            X
X          B            X
X          B            X
X          BBBB         X
X          *BBBXXX      X
X          B            X
X          B            X
X          B            X
X          B            X
X                       X
X                       X
X                       X
X                       X
X                       X
X                       X
X                       X
XF                      X
X                       X
XXXXXXXXXXXXXXXXXXXXXXXXX