XXXXXX
X    X
X    X
X    X
X    X
X  H X
X    X
X    X
XXXXXX